date,student_results,student_positive,student_positive_pct,staff_results,staff_positive,staff_positive_pct,total_results,total_positive,total_positive_pct
2020-10-05 00:00:00,204,1,0.49%,65,0,0.00%,269,1,0.37%
2020-10-04 00:00:00,185,4,2.16%,1,0,0.00%,186,4,2.15%
2020-10-03 00:00:00,713,5,0.70%,211,0,0.00%,924,5,0.54%
2020-10-02 00:00:00,448,4,0.89%,16,1,6.25%,464,5,1.08%
2020-10-01 00:00:00,612,6,0.98%,187,1,0.53%,799,7,0.88%
2020-09-30 00:00:00,329,1,0.30%,162,1,0.62%,491,2,0.41%
2020-09-29 00:00:00,30,0,0.00%,125,1,0.80%,155,1,0.65%
2020-09-28 00:00:00,160,0,0.00%,65,0,0.00%,225,0,0.00%
2020-09-27 00:00:00,381,14,3.67%,97,0,0.00%,478,14,2.93%
2020-09-26 00:00:00,138,5,3.62%,3,0,0.00%,141,5,3.55%
2020-09-25 00:00:00,273,3,1.10%,160,1,0.63%,433,4,0.92%
2020-09-24 00:00:00,299,4,1.34%,139,0,0.00%,438,4,0.91%
2020-09-23 00:00:00,371,8,2.16%,8,0,0.00%,379,8,2.11%
2020-09-22 00:00:00,179,8,4.47%,67,0,0.00%,246,8,3.25%
2020-09-21 00:00:00,167,2,1.20%,69,0,0.00%,236,2,0.85%
2020-09-20 00:00:00,225,17,7.56%,94,0,0.00%,319,17,5.33%
2020-09-19 00:00:00,342,15,4.39%,31,0,0.00%,373,15,4.02%
2020-09-18 00:00:00,333,15,4.50%,31,0,0.00%,364,15,4.12%
2020-09-17 00:00:00,373,16,4.29%,63,0,0.00%,436,16,3.67%
2020-09-16 00:00:00,225,16,7.11%,24,0,0.00%,249,16,6.43%
2020-09-15 00:00:00,97,10,10.31%,24,0,0.00%,121,10,8.26%
2020-09-14 00:00:00,154,0,0.00%,60,0,0.00%,214,0,0.00%
2020-09-13 00:00:00,322,23,7.14%,31,0,0.00%,353,23,6.52%
2020-09-12 00:00:00,253,20,7.91%,7,0,0.00%,260,20,7.69%
2020-09-11 00:00:00,115,1,0.87%,36,0,0.00%,151,1,0.66%
2020-09-10 00:00:00,807,50,6.20%,92,1,1.09%,899,51,5.67%
2020-09-09 00:00:00,21,1,4.76%,53,0,0.00%,74,1,1.35%
2020-09-08 00:00:00,184,0,0.00%,85,0,0.00%,269,0,0.00%
2020-09-07 00:00:00,47,8,17.02%,0,0,-,47,8,17.02%
2020-09-06 00:00:00,168,20,11.90%,25,0,0.00%,193,20,10.36%
2020-09-05 00:00:00,201,24,11.94%,15,0,0.00%,216,24,11.11%
2020-09-04 00:00:00,176,25,14.20%,39,1,2.56%,215,26,12.09%
2020-09-03 00:00:00,216,3,1.39%,83,0,0.00%,299,3,1.00%
2020-09-02 00:00:00,413,48,11.62%,16,0,0.00%,429,48,11.19%
2020-09-01 00:00:00,260,35,13.46%,27,0,0.00%,287,35,12.20%
2020-08-31 00:00:00,0,0,-,0,0,-,0,0,-
2020-08-30 00:00:00,139,27,19.42%,21,0,0.00%,160,27,16.88%
2020-08-29 00:00:00,0,0,-,1,0,0.00%,1,0,0.00%
2020-08-28 00:00:00,144,16,11.11%,56,0,0.00%,200,16,8.00%
2020-08-27 00:00:00,162,14,8.64%,1,0,0.00%,163,14,8.59%
2020-08-26 00:00:00,229,5,2.18%,44,0,0.00%,273,5,1.83%
2020-08-25 00:00:00,333,3,0.90%,31,0,0.00%,364,3,0.82%
2020-08-24 00:00:00,744,2,0.27%,2,0,0.00%,746,2,0.27%
2020-08-23 00:00:00,917,12,1.31%,0,0,-,917,12,1.31%
2020-08-22 00:00:00,740,9,1.22%,0,0,-,740,9,1.22%
2020-08-21 00:00:00,965,13,1.35%,14,0,0.00%,979,13,1.33%
2020-08-20 00:00:00,"1,594",11,0.69%,16,0,0.00%,"1,610",11,0.68%
2020-08-19 00:00:00,"1,560",4,0.26%,26,0,0.00%,"1,586",4,0.25%
2020-08-18 00:00:00,"1,410",5,0.35%,3,0,0.00%,"1,413",5,0.35%
2020-08-17 00:00:00,118,1,0.85%,0,0,-,118,1,0.85%
2020-08-16 00:00:00,698,2,0.29%,0,0,-,698,2,0.29%
2020-08-15 00:00:00,886,4,0.45%,1,0,0.00%,887,4,0.45%
2020-08-14 00:00:00,700,6,0.86%,5,0,0.00%,705,6,0.85%
2020-08-13 00:00:00,685,9,1.31%,0,0,-,685,9,1.31%
2020-08-12 00:00:00,990,6,0.61%,100,0,0.00%,"1,090",6,0.55%
2020-08-11 00:00:00,238,2,0.84%,92,0,0.00%,330,2,0.61%
2020-08-10 00:00:00,255,1,0.39%,43,0,0.00%,298,1,0.34%
2020-08-09 00:00:00,511,5,0.98%,86,0,0.00%,597,5,0.84%
2020-08-08 00:00:00,"1,137",11,0.97%,75,0,0.00%,"1,212",11,0.91%
2020-08-07 00:00:00,"1,098",9,0.82%,21,0,0.00%,"1,119",9,0.80%
2020-08-06 00:00:00,276,0,0.00%,363,1,0.28%,639,1,0.16%
2020-08-05 00:00:00,860,3,0.35%,4,0,0.00%,864,3,0.35%
2020-08-04 00:00:00,329,0,0.00%,152,0,0.00%,481,0,0.00%
2020-08-03 00:00:00,342,0,0.00%,47,0,0.00%,389,0,0.00%
2020-08-02 00:00:00,189,1,0.53%,325,0,0.00%,514,1,0.19%
2020-08-01 00:00:00,681,5,0.73%,176,0,0.00%,857,5,0.58%
2020-07-31 00:00:00,399,6,1.50%,77,0,0.00%,476,6,1.26%
2020-07-30 00:00:00,839,12,1.43%,54,0,0.00%,893,12,1.34%
2020-07-29 00:00:00,792,7,0.88%,634,0,0.00%,"1,426",7,0.49%
2020-07-28 00:00:00,390,4,1.03%,40,0,0.00%,430,4,0.93%
2020-07-27 00:00:00,24,0,0.00%,278,0,0.00%,302,0,0.00%
2020-07-26 00:00:00,0,0,-,541,0,0.00%,541,0,0.00%
2020-07-25 00:00:00,0,0,-,324,2,0.62%,324,2,0.62%
2020-07-24 00:00:00,0,0,-,494,1,0.20%,494,1,0.20%
2020-07-23 00:00:00,0,0,-,6,0,0.00%,6,0,0.00%
2020-07-22 00:00:00,0,0,-,0,0,-,0,0,-
2020-07-21 00:00:00,0,0,-,1,0,0.00%,1,0,0.00%
